https://github.com/iikrllx/dotfiles-debian/blob/master/.neomuttrc

Go to last entry 		G
Go to first entry 		gg
Up 				k
Bottom 				j
Page down 			d
Page up 			u

Sort				Ctrl + o
Refresh messages                Tab

Mark thread read 		Ctrl + r
Mark thread new 		N
Mark delete message 		D
Mark purge message 		H
Mark delete thread 		Ctrl + d
Undelete message (remove mark)	U (u)

Open message 			l, Enter
Edit or view message		e

Group reply 			R
Reply 				r

Forward message 		f
New message 			m

View attachments 		v
Compose to Sender 		@
Save message (to file) 		s
Toggle collapse thread 		Space, Esc+v
Toggle collapse all threads 	Esc+V
Jump to parent message 		P

Show sidebar 			B
Show full sidebar 		y
Up 				Ctrl + k
Down 				Ctrl + j
Open 				Ctrl + o

Help				Shift + ?

Во время отправки нового письма можно использовать:
y:Send  q:Abort  t:To  c:CC  s:Subj  a:Attach file  d:Descrip  ?:Help

------------------------------------------

From: - Адрес отправителя письма.

To: - Адрес получателя письма.

Cc: - Поле "Копия" (Carbon Copy) позволяет указать адреса получателей, которые также получат копию
письма, но не являются его основными получателями. Адреса, указанные в поле Cc, видны всем
получателям письма.

Bcc: - Поле "Скрытая копия" (Blind Carbon Copy) позволяет отправить письмо нескольким получателям,
но скрыть адреса друг от друга. Адреса, указанные в поле Bcc, не видны другим получателям письма.

Subject: - Поле "Тема" содержит краткое описание темы или содержания письма.

Reply-To: - Поле "Адрес для ответа" указывает на адрес, на который должны быть отправлены ответы на
письмо. Если указан, ответы на письмо будут отправлены на указанный адрес, а не на адрес
отправителя (из поля "From").
